10
10
4444444444
4111132314
4110133314
4011112334
4111433314
4121111114
4311411114
4111111114
4111111114
4444444444
