10
10
1111111111
1111111112
2110111112
1111111113
0111411111
1111111114
1111111111
1111111110
1111111111
1111111111
