16
17
4444444444444444
4133033233300304
4333300033323034
4330032033334404
4033330033000334
4000333332333334
4333003300034004
4003330033333334
4333000333333334
4333033233300304
4333300033323034
4330032033334404
4033330033000334
4000333333333324
4333003300034004
4003330033332334
4444444444444444