16
17
4444444444444444
4133033233300304
3333332333333334
4444444444333334
4444444444333334
4332333332333334
4333333300034004
4334444444444444
4334444444444444
4333033032333334
4333300333323034
4444411111333334
4444411511333334
4000311111333334
4333003300034004
4333333333233334
4444444444444444