16
17
4444444444444444
4133011233300104
4333300033321034
4334432011114404
4033310033000134
4000113332333114
4333001100034004
4001330033213334
4004444444444434
4333011233300114
4333300033321034
4330032011114414
4033310033000234
4000113332033114
4344004444201414
4001330033313334
4444444444444444