16
17
4444444444444444
4111132312312304
4110133323123014
4011112323123034
4111433312312304
4121112312301114
4311411231230114
4111111231230114
4111231230111114
4110133323123014
4011012323123034
4111333312312304
4121111312301114
4311511231230114
4111111231230114
4110133323123014
4444444444444444
